"filename", "language", "Java", "XML", "Java Properties", "Batch", "comment", "blank", "total"
"c:\Users\E Praveen Kumar\Downloads\investate\investate\.mvn\wrapper\maven-wrapper.properties", "Java Properties", 0, 0, 3, 0, 16, 1, 20
"c:\Users\E Praveen Kumar\Downloads\investate\investate\mvnw.cmd", "Batch", 0, 0, 0, 108, 26, 16, 150
"c:\Users\E Praveen Kumar\Downloads\investate\investate\pom.xml", "XML", 0, 75, 0, 0, 0, 10, 85
"c:\Users\E Praveen Kumar\Downloads\investate\investate\src\main\java\com\backend\investate\Application.java", "Java", 9, 0, 0, 0, 3, 4, 16
"c:\Users\E Praveen Kumar\Downloads\investate\investate\src\main\java\com\backend\investate\EncryptionNDecryption\Decryption.java", "Java", 69, 0, 0, 0, 9, 6, 84
"c:\Users\E Praveen Kumar\Downloads\investate\investate\src\main\java\com\backend\investate\EncryptionNDecryption\Encryption.java", "Java", 67, 0, 0, 0, 26, 28, 121
"c:\Users\E Praveen Kumar\Downloads\investate\investate\src\main\java\com\backend\investate\config\WebConfig.java", "Java", 15, 0, 0, 0, 0, 5, 20
"c:\Users\E Praveen Kumar\Downloads\investate\investate\src\main\java\com\backend\investate\controller\AuthController.java", "Java", 153, 0, 0, 0, 2, 22, 177
"c:\Users\E Praveen Kumar\Downloads\investate\investate\src\main\java\com\backend\investate\controller\MessageController.java", "Java", 40, 0, 0, 0, 0, 9, 49
"c:\Users\E Praveen Kumar\Downloads\investate\investate\src\main\java\com\backend\investate\controller\NotificationController.java", "Java", 53, 0, 0, 0, 3, 12, 68
"c:\Users\E Praveen Kumar\Downloads\investate\investate\src\main\java\com\backend\investate\controller\PostController.java", "Java", 107, 0, 0, 0, 10, 32, 149
"c:\Users\E Praveen Kumar\Downloads\investate\investate\src\main\java\com\backend\investate\enums\ProfileType.java", "Java", 6, 0, 0, 0, 3, 3, 12
"c:\Users\E Praveen Kumar\Downloads\investate\investate\src\main\java\com\backend\investate\enums\PropertyType.java", "Java", 12, 0, 0, 0, 0, 2, 14
"c:\Users\E Praveen Kumar\Downloads\investate\investate\src\main\java\com\backend\investate\model\Message.java", "Java", 43, 0, 0, 0, 2, 17, 62
"c:\Users\E Praveen Kumar\Downloads\investate\investate\src\main\java\com\backend\investate\model\NotificationsForBroker.java", "Java", 34, 0, 0, 0, 4, 7, 45
"c:\Users\E Praveen Kumar\Downloads\investate\investate\src\main\java\com\backend\investate\model\NotificationsForClient.java", "Java", 34, 0, 0, 0, 3, 4, 41
"c:\Users\E Praveen Kumar\Downloads\investate\investate\src\main\java\com\backend\investate\model\Post.java", "Java", 51, 0, 0, 0, 4, 9, 64
"c:\Users\E Praveen Kumar\Downloads\investate\investate\src\main\java\com\backend\investate\model\Profile.java", "Java", 45, 0, 0, 0, 4, 8, 57
"c:\Users\E Praveen Kumar\Downloads\investate\investate\src\main\java\com\backend\investate\repository\MessageRepository.java", "Java", 11, 0, 0, 0, 0, 4, 15
"c:\Users\E Praveen Kumar\Downloads\investate\investate\src\main\java\com\backend\investate\repository\NotificationRepositoryForBrokers.java", "Java", 9, 0, 0, 0, 1, 4, 14
"c:\Users\E Praveen Kumar\Downloads\investate\investate\src\main\java\com\backend\investate\repository\NotificationRepositoryForClients.java", "Java", 9, 0, 0, 0, 1, 4, 14
"c:\Users\E Praveen Kumar\Downloads\investate\investate\src\main\java\com\backend\investate\repository\PostRepository.java", "Java", 14, 0, 0, 0, 6, 12, 32
"c:\Users\E Praveen Kumar\Downloads\investate\investate\src\main\java\com\backend\investate\repository\ProfileRepository.java", "Java", 15, 0, 0, 0, 9, 10, 34
"c:\Users\E Praveen Kumar\Downloads\investate\investate\src\main\java\com\backend\investate\services\MessageService.java", "Java", 28, 0, 0, 0, 0, 8, 36
"c:\Users\E Praveen Kumar\Downloads\investate\investate\src\main\java\com\backend\investate\services\NotificationServiceForBrokers.java", "Java", 68, 0, 0, 0, 3, 12, 83
"c:\Users\E Praveen Kumar\Downloads\investate\investate\src\main\java\com\backend\investate\services\NotificationServiceForClients.java", "Java", 26, 0, 0, 0, 1, 9, 36
"c:\Users\E Praveen Kumar\Downloads\investate\investate\src\main\java\com\backend\investate\services\PostService.java", "Java", 91, 0, 0, 0, 7, 30, 128
"c:\Users\E Praveen Kumar\Downloads\investate\investate\src\main\java\com\backend\investate\services\ProfileService.java", "Java", 71, 0, 0, 0, 8, 14, 93
"c:\Users\E Praveen Kumar\Downloads\investate\investate\src\main\resources\application.properties", "Java Properties", 0, 0, 9, 0, 1, 3, 13
"c:\Users\E Praveen Kumar\Downloads\investate\investate\src\test\java\com\backend\investate\ApplicationTests.java", "Java", 9, 0, 0, 0, 0, 5, 14
"Total", "-", 1089, 75, 12, 108, 152, 310, 1746